400 400 2 0 100 100
........................O........... 
......................O.O........... 
............OO......OO............OO 
...........O...O....OO............OO 
OO........O.....O...OO.............. 
OO........O...O.OO....O.O........... 
..........O.....O.......O........... 
...........O...O.................... 
............OO......................
